27
11
#####                 #####
#...###################...#
#.P.d..d..d..d..d..d..d...#
#...###################...#
#...#                 #...#
#...###### ############...#
#........# #............T.#
#...####.# #........###...#
#####  #.###........# #####
       #............#      
       ##############      
Title: Not Straight Forward
Subtitle1: Opening doors takes time, too
Timelimit: 33
Critical: 33
