19
9
###################
#........#........#
#........d.....l..#
#........#........#
#..P...Y.##########
#........#........#
#........D.....T..#
#........#........#
###################