20
11
               #####
################...#
#.....d........d._.#
#.....##########...#
#.....#        #####
#.P.Y.#             
#.....#        #####
#.....##########...#
#.....d........D.T.#
################...#
               #####
Timelimit: 40
Critical: 20
Link: Plate#1 => Door#4