################################################################################
#                                                                              #
#                                                                              #
#                                                                              #
#        #######  #  ## ##  #                                                  #
#        #  #  #  ## #   # ##                                                  #
#        #  #  #                                                               #
#        #######                                                               #
#        #  #  #                                                               #
#        #  #  #                                                               #
#        #######                                                               #
#                                                                              #
#                                                                              #
#                                    p                                         #
#                                                                              #
#                                                                              #
#                                                                              #
#                                                                              #
#                                                                              #
#                                                                              #
#                                                                              #
#         ###D#########                                                        #
#         #     #     #                                                        #
#         #     #     #                                                        #
#         #     D     #                                                        #
#         #     #     #                                                        #
#         #     #     #                                                        #
#         #############                                                        #
#                                                                              #
#                                                                              #
#                                                                              #
#                                                                              #
#                                                                              #
#                                                                              #
################################################################################