19
9
###############    
#.......#.....#    
#.......d..l..#    
#.......#.....#    
#..P..Y.###########
#.......#.....#...#
#.......D.....D.T.#
#.......#.....#...#
###################
Link Set    Door#1 Lever#1
Link SetInv Door#2 Lever#1