19
9
###################
#........#........#
#........d........#
#........#........#
#..P.....D.....T..#
#........#........#
#......Y.#........#
#........#........#
###################